#########################################################################################
%                                       !   #                                           #
#   ############   ######################   #   #####################################   @
#   #          #                        #   #   #                                   #   #
#   #   #############################   #   #   #   #############################   #   #
#   #   #                 #         #   #   #       #                           #   #   #
#   #   #   #####################   #   #####   #####   #####   #############   #   #   #
#   #   #         $       #         #       #   #   #   #         #         #####   #   #
#   #   #   #   ###   #######   #   #   #   #   #   #   #   #########   #   #   #   #####
#   #   #   #######   #     #   #   #   #   #   #   #   #           #   #   #       #   #
#   #       #         !     #   #   #   #   #####   #   #   #       $   #   #   #####   #
#   #   #   #   #######     #   #   #   #   #   #   #################   #   #   #   #   #
#   #   #   #   #           #   #   #   #   #   #       #               #   #   #   #   #
#   #   #   #   #############   #   #   #   #   #   #   #   #############       #   #   #
#   #   #   #                   #       #   #   #   #   #           #       #   #   #   #
#   #   #   #####################   #####   #   #   #   #########   #########   #   #   #
#   #   #                    #      #   #   #   #   #                     #     #   !   #
#   #   #############################   #####   #   #############################   #   #
#   #                                       #   #                                   #####
#   #####################################   #   ###########   ################   ####   #
#                                                                           #           #
#########################################################################################

for $
#########################################################################################
#                                       !   #                                           #
#   ############   ######################   #   #####################################   @
#   #          #                        #   #   #                                   #   #
#   #   #############################   #   #   #   #############################   #   #
#   #   #                 #         #   #   #       #                           #   #   #
#   #   #   #######   ###########   #   #####   #####   #####   #############   #   #   #
#   #   #   #     .                 #       #   #   #   #         #         #####   #   #
#   #   #   #   ###   #######   #   #   #   #   #   #   #   #########   #   #   #   #####
#   #   #   #######   #     #   #   #   #   #   #   #   #           #   #   #       #   #
#           #               #   #   #   #   #####   #   #   #       $   #   #   #####   #
#   #####   #   #######     #   #   #   #   #   #   #################   #   #   #   #   #
#   #   #   #   #           #   #   #   #   #       #               #   #   #   #   #
#   #   #   #   #############   #   #   #   #   #   #   #   #############       #   #   #
#   #   #   #                   #   #   #   #   #   #   #           #       #   #   #   #
#####   #   #####################   #   #   #   #   #   #########   #########   #   #   #
#   #   #                    #      #   #   #   #   #                     #     #   !   #
#   #   #############################   #####   #   #############################   #   #
#   #                                       #   #                                   #####
#   #####################################   #   ###########   ################   ####   #
#                                                                           #           #
#########################################################################################