#########################################################################################
%                                           #                                #          @
#   ######   ############################   #   #####################################   #
#   #                                   #   #                                       #   #
#   #   #############################   #   #   #   #########################   #   #   #
#   #   #        #                  #   #   #   #   #                           #   #   #
#   #   #   #    ################   #####   #   #   #   #####################   #   #   #
#   #####   #              #    #   #       #   #   #   #               #   #   #   #   #
#####       #   #####   #  ##   #   #   #   #   #####   #   #    ########   #   #   #   #
#       #####   #       #   #   #   #   #   #   #   #   #   #       #       #   #   #   #
#   #####   #   #       #   #   #   #   #   #   #   #   #   #####   #   #####   #   #   #
#   #   #   #####   #####   #   #   #   #   #   #   #   #   #   #   #   #   #   #   #   #
#   #   #   #   #   #       #   #   #   #   #   #   #   #   #           #   #   #   #   #
#   #   #   #   #####   #####   #   #   #   #   #   #       #####   #####   #   #   #   #
#   #   #   #                   #   #   #   #   #   #####   #               #   #   #   #
#   #   #   ######   ############   #   #   #   #   #   #####   #############   #   #   #
#   #   #                           #   #   #   #   #                #          #   #   #
#   #   #####   #####################   #   #   #   #######   ###################   #   #
#   #                                   #   #   #                           #       #   #
#   #########################################   #########################   #########   #
#                                                                       #               #
#########################################################################################