####################################################################################
%                                                                                  #
#   ############################################################################   #
#   #                  #                                                       #   #
#   #   ################   #################################################   #   #
#   #   #                                                                  #   #   #
#   #   #   ########################################################   #   #   #   #
#   #   #   #                                              #           #   #   #   #
#   #   #   #   ########   #########################################   #   #       #
#       #   #   #                                                  #   #   #   #   #
#   #   #       #   ################   #########################   #   #   #   #   #
#   #   #   #   #   #              #   #                           #   #   #   #   #
#   #   #   #   #   #   ########   #   #   #################   #   #   #   #   #   #
#   #   #   #   #   #   #          #   #   #               #   #   #   #   #   #   #
#   #   #   #   #####   #   ####   #####   #   #   #####   #   #   #   #   #   #   #
#   #   #   #       #   #          #   #   #   #       #   #   #   #   #   #   #   #
#   #   #   #   #   #   ########   #   #       #   #   #   #   #########   #   #   #
#   #   #   #   #   #              #   #   #   #   #   #   #   #   #   #   #   #   #
#   #   #   #   #   ############   #   #   #   #   #   #   #   #   #   #   #   #   #
#   #   #   #   #                      #   #   #   #   #   #   #       #   #   #   #
#   #   #   #   #   ################   #   #   #   #   #   #   #   #   #   #   #   #
#   #   #   #   #   #              #   #   #   #   #   #####   #   #   #   #   #   #
#   #   #####   #   #   ########   #   #   #   #   #       #   #   #   #   #   #   #
#   #   #   #   #   #   #      #   #   #   #   #   #   #   #   #   #   #   #   #####
#   #   #   #   #   #   #      #   #   #   #   #########   #####   #   #   #   #   #
#   #####   #   #####   #              #####     #         #   #   #   #   #   #   #
#   #   #   #   #   #   ########   #   #   ###########   ###   #   #   #   #   #   #
#   #   #   #   #   #              #   #                       #   #   #   #   #   #
#   #   #   #   #   ################   ####   ##################   #   #   #   #   #
#   #   #   #####                         #                        #   #   #   #   #
#   #       #   #   ################################################   #####   #   #
#   #   #   #                                          #               #   #   #   #
#   #   #   ################################################   #########   #   #   #
#   #   #       #                                                          #   #   #
#   #   #############   ####################################################   #   #
#   #                                                            #             #   #
#   ########################################   #################################   #
#                                          #                                       @
####################################################################################